akz1	akz	akzizWa
ac	ac	aYc aYcin aYka aYkas aYcana acana aYcas aNku akzRa
aj	aj	agra aj aja aja ajaka ajana ajira ajma ajya ajra ajvin Aja Aji
aYj	aYj	aNga aNgya aYjaka aYjya ajya Aja Ajya aYjana aYjas aYji aktA akti aktu
aw	aw	awa awana awavI awyA Awa awAwyA
at	at	atasi ati atiTi atiTin atya
ad	ad	ad ada adaka adana adanIya atti attavya attf attra attrin attri atri anna adman adya advan advara Adana Adin Adya
an	an	ana anan anaTa anila Ana Anana
am	am	ama amati amati amatra amana amina amIva amla Ama Amana amaya Amis Amayitnu
arc	arc	arc arka arcA arcaka arcya arcatra arcatri arcana arcanIya arcanAnas arci arcin arcitf arcis fc fca fcas fkti fkva fkvan
arh	arh	arGa arGya arha arhaRa arrhaRA arhaRIya
av	av	ava avana avas avis avitf avitra avizWa avi avI Uti Uma oma oman oman
aS1	aS	aNSa azwi aSana aSI aSnuva aSnuvin ASa ASA
aS2	aS	aS asana aSanA aSanIya aSitavya aSitf aSitra aSuza aSna aSni ASa ASaka
as1	as	asu asta asti Asa itiha sti
as2	as	as asana asanA asanIya asi asira asizWa asti astavya astf astra asya asyA asra Asa Asin Asya Asana
ah	ah	Aha
AYC	AYC	AYCana
Ap	Ap	Apa Apaka Apin Apya Apana ApanIya Apaneya Api Apti Aptavya Aptf ApnAna Apayitavya Apayitf IpsA Ipsin Ipsu Apipayizu
As	As	Asa AsA Asaka Asya AsyA Asana AsanIya Asitavya Asitf Asti
i1	i	aya ayaTa ayana Aya Ayin Ayana Ayu Ayu Ayus Ayuka it iti iti ityA itvan itvara iTa Iti Iya etu etavya etf ema eman eya eva Apin Apaka Apya Apana Apayitf Ayaka Ayana ayitavya Ayitavya
i2	inv	ina inva invaka enas
iNg	iNg	iNga iNgana iNgya iYjanA
iD	inD	iD idDi iDma iDya iDra eDa eDas edDf inDa inDaka inDana
il	il	ilaya
iz1	iz	iCaka iCA iCu iz iza izi izira izwi izmin eza eza ezaka ezin ezya ezaRa ezaRA ezaRIya ezwavya ezitavya ezwf ezizizu
iz2	iz	izaRi izu eza ezaka ezya ezaRa ezitavya ezayitf ezitf
Ikz	Ikz	Ikza IkzA Ikzaka Ikzin Ikzya IkzaRa IkzaRIya IkzeRya Ikzitavya Ikzitf Icikzizu
INK	INK	INKa INKana INKaya
Iq	Iq	Iq Iqya Iqitavya Iqenya Iqitf
Ir	Ir	Ira Iraka Irya IryA Irin IraRa IraRIya Iritf Irma
Irzy	Irzy	IrzyA Irzyaka Irzyin IrzyAlu Irzyu Irzyitavya
IS	IS	IS ISa ISA ISin ISana ISitavya ISitf ISu ISvara
Iz	Iz	IzA eza ezwi ezwf
Ih	Ih	Iha IhA Ihana eha Ehas
ukz1	ukz	ukz ukza ukzan ukzaRa ukzaRIya ukzitavya uzwf uzwf uzwra
uc	uc	oka okya okas okivANs ocana ocara
uJ	ujJ	uJa uJana uJiti
uYC	uYC	uYCa uYCana
ud	ud	ud udaka udan uda udani uditf udman udra utsa undana odatI odana odman
ubj	ubj	udga ubja
uB	uB	umBana
Uh1	Uh	Uha Uhaka Uhya Uhana UhanIya Uhitavya UQi oha oGas
Uh2	Uh	Uha Uhya Uhana UhanIya Uhitavya oha ohas ohasAna
f	f	ara ara arya arya araRa araRi arati araru ari aritf aritra aritra arRa arRas arTa arman arma arvan arva arvant Ara Arin Aruka Arya iras iriRa irya fCA fti fti ftu fTa fRa raTa arpaka arpya arpaRa arpaRIya arpitf arpayitf arpayitavya
fj	arj	arjaka arjya arjana arjanIya arjayitf fjipya fjiSvan fjIpin fjIza fjUnas fNga fjIyas fju raji rajizWa rajIyas rAji
ft	ft	artana artitf artuka
fd	ard	ardaka ardin ardana
fD	fD	arDa arDa arDya arDi arDuka rD rDat fDak fdDi fDnuka IrtsA arDayitf
fz	fz	arza arzaRa arzaRI arzu arzwf fzaBa fzi fzu fzwi fzva
ej	ej	ejaTu ejaya
eD	eD	eDa eDatu eDana eDas ediDizu
katT	katT	katTA katTaka katTin katTana katTitavya
kan	kA	kanA kanaka kanizWa kaniwTa kanIna kanIyas kanyA kAti kAyya
kam	kam	kam kama kamana kamanIya kamitf kamra kAma kAmin kAmya kAmyA kAman kAmana kAmuka kAMti kAmyitavya
kamp	kamp	kampa kampA kampaka kampin kampya kampana kampanA kampanIya kampra kapanA kapi kepi
kal	kal	kalA kalikA kalya kalana kalanIya kalayitf kAlaka kAlana
kaz	kaz	kaza kazaRa kAza kAzin
kas	kas	kasanA kasuka kasti kasvara kAsa kAsaka kAsin kAsana kAsanIya
kANkz	kANkz	kANkza kANkzA kANkzin kANkzya kANkzaRa kANkzaRIya kANkzitavya
kAS	kAS	kASa kASaka kASin kASya kASana kASanIya caNkaSa kASayitavya
kAs	kAs	kAs kAsa kAsA kAsikA kAsana kAs kAsa
kuc	kuc	kuca kucana kuYcaka kuYcana kuYci koca kocaka kocin kocana
kuww	kuww	kuwwa kuwwaka kuwwana
kuT	kuT	koTa koTaka
kup	kup	kupa kupana kupaya kupAyu kupya kopa kopin kopya kopana kopitf kopayizRu cukopavizu
kuz	kuz	koza kozaRa
kU	kU	kUti kavi kavIyas
kUj	kUj	kUja kUjana kUjitavya
kUrd	kUrd	kUrda kUrdana kroda krodin
kf1	kf	kara karaRa karaRa karaRIya karaRi karas karizWa karizRu karuRa kartva kartavya kartf kartf kartra karman karvara kAra kAraka kArin kArya kAraRa kAraRIya kAru kAruka kUrmi in kft kftya kftya kftyA kfti kftu tvas kftvya kftnu kftrima kftvan kftvarI kfTa kra kratu kriyA cakri karikra cikIrz cikIrzA cikIrzu kArayitf kArayitavya cikArayizu cizkArayizu
kf2	kF	kara karaka karitf kAra kAraka kir kira kiraRa kiri kIrya kula
kf3	kf	kAra kArin kAru kIri in kIrti keru carkfti carkftya
kft1	kft	karta garta kartya kartana kartin karttavya karttf kartari kartarI kftA kfti kftti kfnta kfntana kfntatra cikartizA cikartizu
kft2	kft	karttf
kfp	kfp	kfpA kfpaRa kfpaRa
kfS	kfS	karSana kfSa kraSIyas
kfz	kfz	karza karzaka karzin zi karzU karzaRa karzaRIya kArzi zin kArzman kfzi kfzya kfzwi krazwavya krazwf
kxp	kxp	kalpa kalpaka kalpya kalpana kalpanA kalpanIya kalpitavya kxpti kalpayitf kalpayitavya
knU	knUy	knopana
krakz	krakz	krakza krakzin
kraT	kraT	kraTa kraTana krATa krATin krATana
krand	krand	kranda krandin krandya klanda krandana krandanIya krandanu krandas kanikrada
kram	kram	krama kramin kramya kramaRa kramaRIya kramitavya krAma krAmin krAmya krAmaRa krAmuka krAMti krAMtf caNkrama caNkramaRa krAmayitavya
krI	krI	kraya krayaka krayin krayya krayaRa krayaRIya krAyaka krI krIti kretavya kretf kreya
krIq	krIq	krIqa krIqA krIqin krIqana krIqi krIqitf krIqu cikrIqizA cikrIqizu
kruD	kruD	kruD kruDmi kroDa kroDana kroDanIya
kruS	kruS	kroSa kroZaka kroZin kiroZya kloSa kroSana krozwu krozwf kroSayitf
klam	klam	klama klAMti
klid	klid	klindu kleda kledin kledya kledana kledIyas
kliS	kliS	kleSa kleSaka kleSin kleSana klezwf
kvaR	kvaR	kvaRana
kvaT	kvaT	kvaTa kvaTana kvATa kvATayitavya
kzad	kzad	kzattf kzad kzadman
kzan	kzan	kzaRana kzati
kzap	kzap	kzapaRa
kzam	kzam	kzam kzA kzama kzamA kzamaRIya kzaMtavya kzamitavya kzaMtf kzAmya kzAman kzAmi kzAMti kzmA cAkzma kzamApaRa
kzar	kzar	kzara kzaraRa kzAraRa kzIra
kzal	kzal	kzAla kzAlaka kzAlya kzAlana
kzA	kzE	kzARa kzAti kzAma kzAra
kzi1	kzi	kzaya kzA kzas kzas kzayaRa kzatra kzit kziti kzetf kzetra kzema
kzi2	kzi	kzaya dzayin kzayya kzayaRa kzayizRu kziti kzezRu kzapaRa kzapitavya kzapayitf kzapayizRu kzayayitavya
kzip	kzip	kzip kzipa kzipA kzipaRi kzipaRu kzipti kzipra kzepa kzepaka kzepin kzepya kzepan kzepaRa kzepizWa kzepIyas kzeptavya kzeptf kzepnu cikzipsu
kzu	kzu	kzava kzavaTu
kzud	kzud	kzudra kzoda kzodya kzodas kzodizWa kzodIyas
kzuD	kzuD	kzuD kzuDA kzuDya kzuDi kzoDuka
kzup	kzup	kzupa kzumpa
kzuB	kzuB	kzuB kzuBA kzoBa kzoBaka kzoBin kzoBya kzoBaRA kzoBayitf cukzoBayizu
kzRu	kzRu	kzRut kzRotra
kzviq	kzviq	kzveqa kzveqana
kzvel	kzvel	kzvelana kzveli
KaYj	KaYj	KaYja KaYjana
Kad	Kad	KadA Kadira
Kan	Kan	Ka KA Kana Kanaka Kanana KananIya Kani Kanitf Kanitra Kara KAtf KAnaka KAnya KAni Ku Keya
Karj	Karj	KargalA KarjUra
Kall	Kall	Kalla
KAd	KAd	KAda KAdaka KAdin KAdya KAdana KadanIya KAdas KAditavya KAditf ciKAdizu
Kid	Kid	Kida Kidra KidvANs Keda KedA Kedin Kedana Keditavya Kedayitavya
Kud	Kud	Kodana
Kel	Kel	Kela Kelana Keli
KyA	KyA	Kya KyA KyAti KyAtavya KyAtf KyAna KyAyaka KyAyin Kyeya KyApaka KyApin KyApya KyApana KyApanIya ciKyAsu ciKyApayizA
gad	gad	gada gadya gadana gadi gAdin gAdya gadgada
gaD	gaD	gaDya
gam	gam	gaCa gama gamaka gamin gamya gamana gamanIya gamizWa gamizRu gat gati gaMtva gaMtavya gaMtf gaTa gatnu gatvan gatvara gAmin gAmuka gmA gman jmA jman gamayitf gamayitavya jagat jagmi jigatnu jaNgama jaNgamana jigamizu jigAMsu jigamizA
garj	garj	garja garjin garjana garji
gard	gard	garda
garh	garh	garhA garhin garhya garhaRa garhaRIya garhitavya
gal	gal	galana gAlana
galB	galB	galBa
gA1	gA	gA ga gAtu gAtra gAna gAman gAya gU gezRa gaNgA
gA2	gE	gA ga gAya gAyaka gAyin gAyatra gAyana gAyas gAtu gAtavya gAtf gATa gATA gAna gAman gIti gITa geya gezRa jigITa ta gApana
gAh	gAh	gaha gahana gah gaNhman gahvara gAha gAhin gAhya gAhana gAhanIya gamBan gamBara gamBizWa gaBIra gamBIra gaBvara gADa gADana
gu	gu	gut jogU
guYj	guYj	guYja guYjin
guRW	guRW	guRWana
gup	gup	gup gupya gupti gopya gopana gopanIya goptavya goptf gopizWSa jugupsA jugupsu jugupizu
guP	guP	gumPa gumPaka gumPana
gur	gur	gur guraRa gUraRa gUrti goraRa gUrayitf jugurvaRi
guh	guh	guh guha guhA guhya gUha gUhana gUhitavya gUhitf goha gohana gohya
gUrd	gUrd	gUrda
gf1	gF	gara garaRa garitf gir gira gIrya
gf2	gF	gara gala garaRa garas gAra gArin gir gira gila giraRa gilana gra gri gargara jIgarta jigarti
gf3	jAgf	jAgara jAgaraka jAgaraRa jAgarizRu jAgarUka jAgartava jAgftavya jAgfvi
gfD	gfD	gftsa garDa garDin gfDna gfDnu gfDya gfDyA gfDyin gfDra
graT	graT	graTin graTya graTana graTanIya graTitavya graTna granTa granTin granTana granTi
graB	grah	graBa graha grahin garBa graBaRa grahaRa grahaRIya grahi grahizRu grahItavya graBItf grahItf grABa grAha grAhaka grAhin grAhya grAhi grAhuka gfB gfh gfBa gfha gfhya gfBi gfhu gfhIti jiGfkzA jiGfkzu grAhayitavya
gras	gras	grasya grasana grasizWa grasizRu grasti grastf grAsa grAsaka
glah	glah	glaha glahA glahana
glA	glE	glA glAni glAvin glAsnu glApana glapana
Gaw	Gaw	Gawa Gawaka Gawana GawanA GAwa GAwaka GAwin GAwana GAwanIya GAwi Gawayitavya
Gaww	Gaww	Gawwa Gawwin Gawwana Gawwitf
Gas	Gas	kzu Gasa Gasana Gasmara Gasra Gasvara Gasi GAsa GAsin GAsya GAsi gDi jiGatsA jiGatsu
Guw	Guw	Gowa
Guz	Guz	Guza Guzya Goza Gozaka Gozin GozaRa GozaRA GozaRIya Gozi Gozwf
GUrR	GUrR	GUrRa GUrRana
Gf	Gf	Gara GArin GAraRa jaGri Garma GfRa GfRA GfRi
Gfz	Gfz	Garza Garzin GarzaRa Gfzwi Gfzu Gfzva Gfzvi
GrA	GrA	Gra GrARa GrAti GrAtavya GrAtf Greya jiGra jiGraRa GrApaRa
cakz	cakz	cakz cakzA cakzin cakzya cakzan cakzaRa cakzaRi cakzas cakzu cakzus
caw	caw	cAwa cAwana cAwanIya
cat	cat	cat catin cAtana catnuka
can	can	canas canizWa cAru
cam	cam	camaka cAma camana camasa camU cAMti
car	car	cara carA caraka carya caryA caraTa caraRa caraRi caraRIya careRya caritavya cartavya caritf cartitra carizRu carzaRa carzaRi cAra cAraka cArin cArya cAraRa cAraRIya cAruka ceru cacara carcara carAcara cArayitavya cArayitf cicarizu
carc	carc	carcA carcaka carcana carci carcI
carv	carv	carvya carvaRa carvaRA cUrRi
cal	cal	cala calaka calAka calana calI calU calitavya cAla cAlin cAlya cAlana cAcala cAcali caYcala calAcala cicalizu
cAy	cAy	cAyanIya cAyitf cAyu citi
ci1	ci	kAya caya cayana cayanIya cayitavya cayizWa cAya cAyin cAyya cit citya cityA citi cIti cetavya cetf ceya cicIzA
ci2	ci	caya cayana cAyaka cAyin cit citi cetavya cetf ceya cira
cit	cit	keta ketana ketu cit citi citti citti citra cetya cetana cetanA cetas cetizWa cetu cetuna cettf cetyA cikit cikiti cikitu cikitvan cikitvit ciketas cikita cikitsA cikitsaka cikitsya cikitsana cikitsanIya cikitsu cetayitavya cetayitf
cint	cint	cintA cintaka cintin cintya cintana cintanIya cintitf cintayitavya
cud	cud	coda coda codaka codin codya codana codanA codanIya codas coditf codizWa codayitavya codayitf
cup	cup	cumpuna
cumb	cumb	cumbA cumbaka cumbin cumbana
cur	cur	cora coraka corayitavya
cUz	cUz	cUzin cUzya cUzaRa coza cozya cozaRa
cft	cft	cartya cartana cft cftya
cezw	cezw	cizwu cezwa cezwA cezwana cezwitavya cezwayitf
cyu	cyu	cyava cyavana cyavas cyavIyas cyAva cyAvana cyAvuka cyut cyuti cyOtna cyAvayizRu cyAvayitavya
Cand	Cad	Cad Canda Canda Candaka Candya Candana Candas Candu
CA	Co	CavI vi CAna
Cid	Cid	Cid CidA Cidura Citti Cidra Ceda Cedaka Cedin Cedya Cedana CedanIya Cettavya Cettf ciCitsu
Cur	Cur	CuraRa
Cfd	Cfd	Cardana CardanIya Cardi Cardis Cardayitavya
jakz1	jakz	jagDi
jan	jan	gnA jana jana janaka janya janana janas ja ja jAti jani janI janu janU janus jantu jantva janitva janitavya jAtu jAtU jAtf jAna janitf janitra janman janiman janizWa janizRu janizya jAni jAman jAmA jAmi jenya jAnuka jajYi janayati janayitavya janayitf janayizRu jijanayizitavya jAyA jAyin jAvan jAvara
jap	jap	japa japin japya japana japanIya japtavya jApa jApaka jAPin jApya jaYjapa jaYjapUka
jamB	jaB	jamBa jamBa jamBaka jaBya jamBana
jalp	jalp	jalpa jalpaka jalpin jalpya jalpana jalpi jalpitf jarjalpa
jas	jas	jasu jasuri jasra jasvan
ji1	ji	jaya jayin jayya jayana jayus ji jit jityA jiti jitvan jitvara jina jizRu jayizRu jetva jetavya jetf jayitf jeman jeman jeya jeza jezin jAyin jAyu jAyuka jigyu jigIzA jigIzin jigIzu jApayitf
ji2	jinv	jIra jIri jinva
jIv	jIv	jIva jIvaka jIvin jIvya jIvana jIvanIya jIvas jIvAtu
juz	juz	jus juza juzwi joza jozya jozaRa jozas jozwf jozayitavya jozayitf
jU	jU	java javin javana javas javizWa javIyas juvas jU jUti
jf1	jur	jara jarA jaraRa jaraRi jaras jariman jarUTa jAra jAraRa jirvi jivri jIrti jIrRi jur jurya jUrya jUrRi jaguri jarjara jarayitf jarayu jarAyu jarizRu
jf2	jF	jaraRA jarA jaritf jUrRi
jYA1	jYA	jAnaka jYA jYa jYAs jYAna jYAti jYAtavya jYAtf jYAtra jYAya jYeya jajYi jijYu jYapya jYapana jYapti jYApaka jYApya jYApana jYApanIya jYApayitavya jijYAsA jijYAsya jijYAsana jijYAsenya jijYAsitavya jijYAsu
jyA	jyA	jIti jyA jya jyAna jyAni jyAya jyeya jyeya jyAyuka jyAyas jyezWa jyAyizWa
jyut	jyut	jyuti jyotA jyotana jyotaya jyotis jyotanA
jri	jri	jraya jrayas jrayasAna jri
jfmB	jfmB	jfmBa jfmBA jfmBaka jfmBin jfmBaRa
jvar	jvar	jvara jvAra
jval	jval	jvala jvalana jvalitf jvAla jvAlA jAlin jvAlana
waNk	waNk	waNka
qamb	qamb	qamba qambaka qambin qamb ya qambana
qI	qI	qayana qIyana qItara qiyAna qIyAna
QOk	QOk	QOkana
tak	tak	takana taku takavAna takri takva takvan takvarI
takz	takz	takza takzaka takzya takzan takzaRa tazwi tazwf
taMs	taMs	taNsa taNsana taNsu tasara tasti tantasAyya titau
taYc	taYc	taNka taNkya taYcana takman takra
taq	taq	taqit tAqa tAqaka tAqin tAqya tAqana tAqanIya tAqayitf
tan1	tan	tan tana tanA tanaya tanas tani taniman tanizWa tanIyas tanu tanU tanus tanti tati tantu tanitf tantra tatni tatnI tatnu tA tAna tAnaka tAnuka tAyitf tatanuzwi tena titANsu
tan2	tan	tanyatA tanyatu tanyu tanayitnu
tand	tand	tandra tandri tandrI
tap	tap	tap tapa tapya tapana tapana tapanI tapas tapu tapus tapuzi tapuzI tapti taptavya taptf tapizWa tapizRu tapIyas tapyatu tApa tApaka tApin tApya tApana tApitf tApayitf tApayizRu
tam	tam	tamaka tamana tamas tamI tamizIci tamisra tAMti tameru tamra tAma tAmaka tAmI tAmra
tark	tark	tarka tarkA tarkaka tarkin tarky a tarkaRa tarkaRIya tarkuka
tarj	tarj	tarjaka tarjana tarjanA
tij	tij	tikti tigita tigma tIkzRa tega teja tejana tejas tejizWa tejIyas titikzA titikzu
tim	tim	timi timira
tu	tu	tavA tavya tavya tavas tavas taviza tavizI tavIyas tavyas tIvra tumra tura tuvi tuvis tUya tUtuma
tuj	tuj	tuj tujya tuji tuYja tugra tugvan tuNga tUtuji
tud	tud	tud tuda tunda toda todin todya todana tottra
turv	turv	turva turvan turvaRi turvIti tUrvi
tul	tul	tula tulA tulya tulana tolaka tolya tolana
tuS	tuS	toSa toSana toSas
tuz	tuz	tuzwi tUzRIm toza tozaka tozin tozya tozaRa tozaRIya tozwavya tozayitavya tozayitf
tf	tF	tara tarin tarya tari tarI taraRa taraRIya taraRi taraTa tira tur tura turaRa taras taras tarIyas taru taruRa tarus taruza tarUzas tiras turas turi turyA tartavya taritavya tarItu tarItf tarutf tarutra taritra tarman tIra tIrTa tUrti tUrRi tUrya toraRa tAra tAraka tArin tArya tAraRa tAraRIya tArayitf titIrzA titIrzu taturi tartura tuturvaRi
tfd	tfd	tarda trada tardana tardi tardman tfd tftti tfRman tfdila tftsu
tfp	tfp	tarpaka tarpya talpa tarpaRa tarpaRIya tfp tfpa tfpala tfpti tfpti tfpra tfpsu tAtfpi tarpayitavya
tfz	tfz	tarza tarzyA tarzaRa tarzula tfz tfzA tfzyA tfzu tfzRA tfzRaj
tfh	tfh	tarhaRa
tyaj	tyaj	tyaj tyaja tyajya tyajana tyajas tyajas tyaktavya tyaktf tyAga tyAgin tyAjaka tyAjya tyAjana
trap	trap	tfpra trapa trapA trapaRa trapaRIya trapu
tras	tras	trasa trasana trasara trasnu trAsa trAsaka trAsin trAsana trAsanIya trAsuka
trA	trE	trA tra trARa trAtavya trAtf trAtra trAman trAvan trayayAyya
truw	truw	truwi trowaka
tvakz	tvakz	tvakzaRa tvakzas tvakzIyas tvazwi tvazwf
tvar	tvar	tvara tvarA tvaraRa tvaraRIya
tviz	tviz	tviz tvizA tvizi tveza tvezin tvezya tvezaTa tvezas
tsar	tsar	tsarA tsaru tsAra tsArin
dakz	dakz	dakza dakzas dakzAyya dakziRa
daG	daG	daG daGna daGvan
daMS	daMS	daNSa daNSaka daNSin daNSana daNSuka daNzwf daNzwra daNzwrA daNSman daNkzRu daSA daSana
daMs	daMs	daNsa daNsana daNsanA daNsas daNsizWa daNsu dasmant dasma dasra
daB	daB	daBa daBya daBIti dabDi daBna daBra dABa dABya damBa damBaka damBin damBana dipsu
dam	dam	dam dama dama damaka damin damya damatra damana damitf damayitf
day	day	dayA dayitnu
dal	dal	dala dalana dAla dAlaka dAlana dAlya dAli dalayitf
dAS	dAS	dAS dASa dASu dASuri
das	das	dasa dasya dasvant dasyu dAsa dAsin dAsanu dAsuka
dah	dah	dah dahati dahana dagDavya dagDf dakzI dakzu Dakzu dakzus dAGa dAha dAhaka dAhin dAhya dAhana dAhuka diDakzA diDakzu
dA1	dad	dA da dAti tti dAtavya dAtf dAtra dAna dAna dAman dAman dAya dAyaka dAyin dAvan dAvan dAnu deya deya dAs das di diya dezWa dezRa dad dada datti datra dAda daditf dadi ditsA ditsu diditsu dApin dApya dApana dApanIya dApayitavya dApayitf
dA2	dA	tti dAtu dAtavya dAtf dAtra dAna dAna dAnIya dAnu dAya diti deya
dA3	dA	dAtf dAna dAman dAman dAya di diti dIna
dA4	dE	dAna
diS	diS	diS dizwi deSa deSaka deSin deSya deSana deSanA dezwavya dezwf dezwra didikzA didikzu
dih	dih	dih deGa deha dehI dehikA dehya dehalI
dI2	dI	dIti dIditi dIdi dIdivi dIDiti
dIkz	dIkz	dIkzA dIkzaka dIkzaRa dIkzayitf
dIp	dIp	dIpa dIpaka dIpin dIpana dIpti dIpra
dIv1	div	dIv dyU dIvan dIvana deva devana devin devitavya devitf dyUtya
dIv2	div	deva devaka devin devana
du	du	dava davya davaTu dAva dAvya dUyana doman
duD	duD	duDi duDra doDaka
dul	dul	dulA dola
duz	duz	dus duzwi dUza dUzaka dUzin dUzya dUzaRa dUzi doza dozA dozin dozya dozas dUzayitf
duh	duh	duh duG duha duGa duhitf doha doGa dohaka dohin dohya dohana dohana dohas dohas dogDavya dogDf dogDra duDukzu
df1	dF	dara daraRa daraRIya dari darIman dartf dartnu darman darma dAra dAraka dArin dAraRa dAri dAru dAruRa dir dura dfti dfvan dra driya dadru dardira
df2	df	dara darin daraRa daraRIya dartavya dAra duri dftya
dfp	dfp	darpa darpaka darpin darpaRa dfpti
dfB	dfB	darBa dfBIka darBaRa
dfS	dfS	darSa darSa darSaka darSin darSya darSata darSana darSanIya dfS dfSa dfSya dfSati dfSi dfSIka dfSIku dfSenya dfzwi dfSna dfSvan dfkza drazwavya drazwf dreSya didfkzA didfkzu didfkzeya didfkzeRya darSayitf
dfh	dfMh	dfh dfNha dfNhaRa dfNhitf drahyat
dyut	dyut	dyut dyuta dyuti dyota dyotaka dyotin dyotya dyotana dyotana dyotani dyotis dyotman didyut dyotayitavya
drA1	drA	dra drAk drApi daridra
drA2	drE	drA didrAsu
dru	dru	drava dravya dravaRa dravara dravi dravitf dravitnu draviRa drAva drAvin drAvya drAvaRa dru druti drAvayitnu
druh	druh	druh druhya druhu druhyu druhiRa druhvan droGa droha drohin drogDavya drogDf duDrukzu
dviz	dviz	dviz dviza dvizeRya dvizwi dveza dvezaka dvezin dvezya dvezaRa dvezaRIya dvezas dvezwf
Dan	Dan	DanizWa
Danv	Danv	Danutf
Dam	Dam	Dama Damana Damani Damitra Dma DmA DmAna DmAnIya DmAtavya DmAtf DmApana
Dav	Dav	DavIyas
DA2	De	DA Daya DAtu DAyin DAyas DAyu DAru DAsi DAsyu DenA Denu daDan daDi
DA1	DA	Da DA DAna DAnA DAnIya DAtu DAtavya DAtf DAman DAya DAyaka DAyin DAyya DAyu DAsi Das Di Diti hiti Deya Deya DezWa daDa daDi daDus daDizu diDizu diDizAyya DitsA Ditsu DApana DApayitavya
DAv1	DAv	DAvaka DAvin DAvana DAvitf DArA
DAv2	DAv	DAva DAvaka DAvin DAvana DOti DArA
DI	dIDI	DI DIti DIra DIvan DiyasAna dIDayu dIDiti
Dukz	Dukz	DukzaRa
DU	DU	Du Dava Davana DAva Davitavya Davitra Duvaka Duvana DUti Duti Duni DUnana
Df	Df	Dara DaraRa DaraRIya DaraRi DaruRa Dartu DarItu Dartf Dartra Daritf DarRasi DarRi Darman Darman Darma Dariman DarIman DarIyas DAra DAraka Darin DArya DAraRa DAraRIya DAri DIra Dur Dura Dft Dfk Dfti Dftvan Dra Dri Druva Druvas Druvi dADfvi dfDra diDIrzA diDIrzu DAraya DArayu DArayitavya DArayitf DArayizRu diDArayizA
Dfz	Dfz	Darza Darzaka Darzin Darzya DarzaRa DarzaRIya Dfz Dfzaj Dfzwi DfzRu Dfzya daDfza dADfzi daDfzvaRi Darzayitavya
DyA	DyE	DyA DyAyin DyAna DyAtavya DyAtf Dyeya diDyAsana diDyAsitavya diDyAsu
Draj	Draj	Drajati Drajas Draji DrAj DrAja DrAji DrAji
DvaMs	DvaMs	Dvasa Dvasan Dvasani Dvasanti Dvasira Dvasti Dvasman Dvasra DvaNsa DvaNsaka DvaNsin DvaNsana DvaNsi
Dvan	Dvan	Dvana Dvanya Dvani Dvanana DvAna Duni danDvana
Dvf	Dvf	Dur DUrti DoraRa Dru Drut Druti DvarA Dvaras Dvartavya Dvft
nakz	nakz	nakzatra nakzya
naw	naw	nawa nawana nawanIya nAwa nAwaka nAwin nAwayitavya
nad	nad	nada nadI nadin nadaTu nadanu nAda nAdin nAdi nAdana nAnada
nand	nand	nanda nandaka nandin nandya nandana nandanIya nandi nanditf nandaTu nAndana nAndI nAnduka nanAndf nandayitavya nandayitf
naB	naB	naB naBanu naBanU naBanya naBas naBAka naBya nAB nABi
nam	nam	nam nama namana namanIya namas namasAna namI nati naMtva naMtf namra nAma nAmaka nAmin nAmya nAmana nAmuka nemi nannama ninaMsu namayitavya namayitf namayizRu
nard	nard	narda nardin nardana
naS1	naS	naS naNSin naSana naNSuka nazwi naSvara nASa nASaka nASin nASya nASana nASuka nAzwrA nASayitf
naS2	naS	naNSa naNSana naSa nASa
nah	nah	nah naD nahana nahas nahus nadDi nadDavya nAha nAhya nAhana nAhuka
nAT	nAT	nATa nADa nADas
nikz	nikz	nikzaRa nIkzaRa nekzaRa
niMs	niMs	niNsin
nij	nij	nij nikti neka nega neja nejaka nejya nejana nektf
nind	nind	nid nidA nedya nindA nindaka nindin nindya nindana nindanIya ninditf ninitsu
nI	nI	nI naya nayin nayana nAya nAyaka nAyin nAyya nAyana nIti netavya nayitavya netf nayitf netra nITa nITA neman nIya neya nayizWa neza nezwf nenI ninIzA ninIzu ninIzeRya
nu1	nu	nava navya navana navizwi nAva nuti nonuva
nud	nud	nud nuda nutti noda nodaka nodin nodya nodana nottavya nunutsu nodayitavya
nft	nft	nft nftya narta nartaka nartin nartana nfti nfti nftu nftU nftti nartitavya nartayitf ninartizA
ned	ned	neda
pac	pac	pac paca pacya pacana pacata pacatya pakti pakti paktavya paktf paktrima pakTa pakTin pakva pacelima pAka pAkin pAkya pAcaka pAcin pAcya pAcana pAcayitf
paj	paj	pajra pAjas
paw	paw	pAwa pAwaka pAwin pAwya pAwana pAwanIya
paW	paW	paWaka paWana paWanIya paWitavya paWiti pAWa pAWaka pAWin pAWya PAWana
paR	paR	paRa paRin paRya paRana paRI paRAyya vaRij paRitf pARa pARi paRayitf
pat1	pat	pat pata patana ptu patAka patitavya pattra atatra patman patya patvan patara pataru patizWa patizRu patIyas pAta pAtaka pAtin pAtya pAtana pAtanIya pAtuka paptani patApata pipatizu pitsu patayAlu patayizRu pAtayitf
paT	paT	paT panTA paTan pATas pATis
pad	pad	pad pAd pada padana padanIya padi patti pattavya pattf padva pAda pAdaka pAdin padya pAdana pAdanIya pAdu pAduka pitsA pitsu patsu pAdayitavya pAdayitf pipAdayizA pipAdayizu
pan	pan	pana panya panAyya panas panu panitf panizwama panizwi panizWa panIyas panyas panyA panyu panayAyya
paS1	paS	paS paSya paSyin paSyata paSyana spaS spaSa spASana paspaSA
pA1	pA	pa pA pAna pAnIya pAtavya pAtf pAtra pAnta pAyaka pAyin pAyya pAyana pAvan pitu pIti pITa peya piba papi pipAsA pipAsu pipIzu pAyayitavya
pA2	pA	pa pA pAna pAtavya pAtf pAtra pAyu pAyya pAla pAvan pati pitf pIti pITa pITya
pAy	pAy	pAyu
pi	pI	paya payas pyasa pit pitu pIyUza pIva pIvan pIvANs pIvara pIvas pIvizWa
pinv	pinv	pinva pinvana
pibd	pibd	pibdana
piS	piS	piS piSa piSanga piSAca piSAci piSuna peSa peSI peSana peSas peSitf
piz	piz	peza pezaka pezya pezI peSaRa pezwf pezwra pipizvant
pis	pis	pesuka
pIq	pIq	pIqa pIqA pIqaka pIqin pIqana pIqanIya pIqayitavya pIlana pipIla
pIy	pIy	piyAru pIyaka pIyatnu pIyu
puw	puw	puwa puwaka puwana powa powaka powana
puT	puT	poTa poTaka
puz	puz	puz puzya puzka puzpa puzwi puzwi pUza pUzan pUzaRa pUzarya poza pozaka pozin pozya pozaRa pozaRIya pozas pozuka pozwf pozitf pozayitnu pozaizRu
pU	pU	pU pu pvA pava pavA pavyA pavana pUti pUtrima potf potra pavItf pavitf pavitra pAva pAvaka pAvana puna pavayitf
pUj	pUj	pUjA pUjaka pUjya pUjana pUjanIya pUjayitf pUjayitvya
pUy	pUy	pUya pUti
pf1	pF	pur paraRa parus parvan puru parIRas parIman pareman purIza pUrti pUra pUraka pUrin pUrya pUraRa pUraRIya pfRa papri papuri pupuri puraya pUrayitf pUrayitavya
pf2	pf	paraRa partf parza parzin parzaRi parzizWa pAra pArin pAraRa pAraRIya peru papri pipru pAraya pArayitf pArayizRu
pf3	pf	pra pAra
pfc	pfc	pfc parka parcana pfkz pfkza prakza
pyA	pyE	pyAya pyAyin pyAyya pyAyana pyAyayitf
praC	praC	pfC prAC pfCA pfCaka pfCya prazwavya prazwf praSna praSnya pipfCizu papfkzeRya prAS pipfkzu
praT	praT	pfT pfTa pfTak pfTavAna pfTi pfTI pfTu pfTivI praTA praTana praTas praTu praTiman praTizWa praTIyas praTasnu praTayitf
prA	prA	prA pra prARa prAvan
prI	prI	prI priya prayas prIti pretf preRi preman preyas prezWa piprIzA piprIzu prIRana prIRayitf
pru	pru	prava pravaRa prut
pruT	pruT	proTa proTaTa
pruz	pruz	pruz prUz pruzvA pfzvA
plu	plu	plava plavaka plavin plavana plavitf pluti plAva plAvaka plAvin plAvya plAvana plAvayitf
pluz	pluz	pluzi ploza plozin plozaRa
psA	psA	psAnIya
PaR	PaR	PaRa PARwa Pena
Par	Par	ParvI Parvara PAriva parParIka
Pal1	Pal	Palaka Palin PAla Pulla
Pal2	Pal	Pala Palitavya
baMh	baMh	bahala bahu baNhizWa baNhIyas bAhu
banD	banD	banDa banDaka banDin banDya banDana banDanIya banDu banDuka badDavya bandDf bandDra baDira banDayitf
bAD	bAD	bAD bADa bADA bADaka bADin bADya bADana bADanIya bADas bADitavya bADitf bIBatsa bIBatsA bIBatsu bADayitf
buD	buD	buD buDa buDya buDan boDa boDaka boDin boDya boDana boDanIya boDi boDit budDi bodDavya boDitavya bodDf buButsA buButsu boDayitavya boDayitf boDayizRu buboDayizu biboDayizu
bfh1	bfh	bfh barha barhaRa barhaRA bfhant barhas barhizWa barhis brahman brahman bfNhin bfNhaRa bfNhaRIya bfNhayitavya
brU	brU	brava bruva
Bakz	Bakz	Bakza Bakzaka Bakzin Bakzya BakzaRa BakzaRIya Bakzitavya Bakzitf Bakzivan Bakzayitf Bakzayitavya biBakzayizA biBakzayizu
Baj	Baj	BAj Baga Bajin Bajya Bajana BajanIya Bajenya Bakti Bajitavya Baktf BAga BAgin BAgya BAgIyas BAja BAjaka BAjin BAjya BAjana BAjayu
BaYj	BaYj	BaNga BaNgin BaNgi BaYjaka BaYjana BaYjanu BaNktf BaNgura
BaR	BaR	BaRa BaRana BaRanIya BaRiti BARa BARaka biBaRizu
Band	Band	Bandana BandizWa Badra
Barts	Barts	Bartsana
Barv	Barv	Barva BArvara
Baz	Baz	Baza Bazaka BazaRa BAz
Bas	Bas	Bas Basa BastrA Basman psu baBasa
BA	BA	BA Ba BAna BAti BAnu BAma BAvan BAvarI BAs
BAm	BAm	BAma
BAz	BAz	BAz BAza BAzA BAzaka BAzin BAzya BAzaRa BAzaRIya BAzitavya BAzitf
BAs	BAs	BAs BAsa BAsaka BAsin BAsya BAsana BAsas BAsura BAsvara
Bikz	Bikz	BikzA Bikzin BikzaRa Bikzitavya Bikzu Bikzuka
Bid	Bid	Bid Bida BidA Bidya Beda Bedaka Bedin Bedya Bedana BedanIya Bindu Bidura Bitta Bitti Bettavya Bettf biBitsA biBitsu biBedayizu BidApana
Bizaj	Bizaj	Bizaj Bezaja
BI	BI	BI Baya Bayya Biyas BiyasAna BIti Betavya BIma Beya BIru BIla BIs BIzA BIzaka BIzaRa BIzma
Buj1	Buj	Buj Buja Boga Buji Bujman Bujyu
Buj2	Buj	Buj Boja Bojaka Bojin Bojya Boga Bogin Bogya Bojana BojanIya Bojas Buji Bogi Bogaya Bukti Boktavya Boktf Bujizya BujizWa buBukzA buBukzu Bojayitavyta Bojayitf
BU	BU	BU Bu Bva Buva Bava Bava Bavaka Bavin Bavya Bvan Bavana BavanIya Buvana Bavas Buvas BUti BUti BavItva Bavitavya Bavitf Bavitra BUman BUman BUmi BUmI BUyas BavIyas BUyizWa BavizWa BUri BUvarI BUzRu BavizRu BUya BAva BAvaka BAvin BAvya BAvana BAvanIya BAvuka buBUzA buBUzaka buBuzitavya buBUzu BAvayitavya BAvayitf BAvayu
BUz	BUz	BUzA BUzya BUzaRa BUzeRya BUzitavya BUzayitavya
Bf	Bf	Bra Bara Bala BaraRa BaraRIya Baras Bari Baru Barata Bartavya Bartf BrAtf Baritra BarRas Barman BarIman BArman Bariza BrURa BAra BArin BArya Bft Bfti Bfti Bftya Bftya BftyA Bftenya Bftra Bftvan BfTa baBra baBri jarBari bamBAri buBUrzA buBUrzu
Bfjj	Brajj	barjjana Bfjjana Brazwra BrAzwra
Byas	Byas	Byasa
BraMS	BraMS	BraNSa BraNSin BraNSana BraNSaTu BraNSuka BrASya
Bram	Bram	Bfma Bfmi Bfmi BfNga Brama Bramin BramaRa BramaRIya Brami BrAMti BrAma BrAmaka BrAmin BrAmaRa
BrAj	BrAj	BrAj Braj Barga BrAja BrAjaka BrAjin BrAjana BrAjas Brajas Bargas BrAji BfAjis Bfgu BrAzwi Bfzwi BrAjizWa BrAjizRu
Brez	Brez	Breza
maMh	maMh	maGa maNhanA maNhanIya maNhIyas maNhizWa makzu maNkzu maNhayu maKa majman mah maha maha mahA mahya mahan mahana mahanIya mahant mahas mahas mahi mahin mahiman mahman mahis mahiza mahizWa mahIyas mahayya mahAyya mahayAyya
majj	majj	majjan majjana majjUka maNktavya madgu majra mimaNkzu majjayitf
maYc	maYc	maYca maYcana
maRq	maRq	maRqa maRqana maRqitf
maT	maT	maT maTa maTya maTya maTan maTana maTi maTi maTitf maTna maTra mATa mATin manTa manTA manTaka manTya manTana manTanI manTItavya manTitf manTu manTAna manmaTa
mad	mad	mad mAd mada madin madya madana maditavya madira madra madvan madvara madizWa madizRu matsara matsya maderu mAda mAdaka mAdin mAdya mAdana mAduka medin madAmada madayitf mAdayitf mAdayitnu mAdayizRu manda mandin mandana mandi mandAra mandu mandra mandizWa mandasAna mandayu mandayitf
man	man	mana manA manas manIzA manu manu manus manana mananA mati mantu mantavya manotf mantf mantra manman manyu mAti mAna mAnaka mAnin mAnya mAnana mAnanIya mAnuka muni manya manyaka mImANsA mImANsaka mImANsya mimAnayizu mAnayitf mAnayitavya mananIya
mA1	mA	mA mAna mAna miti mAtavya mAtf mAtf mAtrA mAyA mAyu mAs mas meya mitsA mApaka mApya mApana
mA2	mA	maya mAtavya
mA3	mA	mAyu mayu mayUra
mArg	mArg	mArga mArgin mArgaRa mArgitavya
mikz	mikz	mizra miSla mikzA mekzaRa mimikzu
miT	miT	miTati miTas miTu miTuna miTus miTyA meTaka meTana
mil	mil	milana mela melaka melana melApaka melApana
miz	miz	miz miza meza mezaRa memiza
mih	mih	mih mihya meGa meha mehin mehanA mehana mehanIya mehatnu meQra meRQra mIQa mIQvANs
mI	mI	mI maya mIya mayu mAyu mAyuka mIti mAtavya mApana mApayitf
mIl	mIl	mIla mIlaka mIlin mIlana
mIv	mIv	mu mUra mavizRu mota
muc	muc	muc mucI muca moka mokI mokya moca mocaka mocin mocya mocana mocanIya muci mucu mukti moktavya moktf mucyu mukzA mokza mokzaka mokzin mokzya mokzaRa mokzaRIya mumucu mumukzA mumukzu mocayitf mocayitavya mumocayizu mokzayitavya mokzayitf mumokzayizu
muw	muw	mowaka mowin mowana
mud	mud	mud muda mudA moda modaka modin modana modanIya mudra mudira mudvin
muz	muz	muz mUs mUza muzaka mUzaka muzi muzIvan muzwi moza mozaka mozin mozya mozaRa
muh	muh	muh muhu muhus muDA moGa moha mohaka mohin mohana mohuka momuGa mohayitf
mUrC	murC	mUra mUrti mUrKa mUrCA mUrCana
mf1	mf	mara maraka maraRa maru mura marAyu marta martya mfti martavya mftyu marman mAra mAraka mArin mAraRa mAruka mamri murmura mumUrzA mumUrzu mimArayizu
mf2	mfR	mur mura muri marItf mfRa malimlu
mfkz	mrakz	mfkza mfkzin mrakza mrakzaRa
mfc	mfc	mfc marka marka mfcaya
mfj	mfj	mfja mfjA marjya mArga mArjaka mArjana mArjanIya mArguka mArjAra mArjAlya mfzwi mArzwi mArzwavya mfgra mfgvan marmfjenya
mfq	mfq	mfqa mfqana mfqIka marqitf mfqitf mfqaya mfqayAku mfdya
mfd	mfd	mfd mfda marda mardaka mardin mardana mardanIya mradas mfttikA marditavya marditf mradIyas mfdu mftsnA mimardizu mimardayizu
mfD	mfD	mfD mfDa mfDas marDuka mfDra
mfS	mfS	mfSa mfSya marSa marSaka marSin maSana marImfSa
mfz	mfz	mfzA mfzya marza marzin marzaRa marzaRIya marzi
med	mid	medana medin medya medas medura
mnA	mnA	mnAna mnAtavya mnAya
mrit	mrit	mretuka
mruc	mluc	mruc mroka mloca mrocana mlocana mloci mrukti mlukti malimluca malimluc
mreq	mreq	mreqa
mlA	mlE	mlAni mlAyin mlApana mlApin
mleC	mleC	mleCa
yakz	yakz	yakza yakzin yakzya yakzu yakzma yakzman
yaj	yaj	ij yaj yAj yaja yajA yajin yajya yajyA ijya ijyA yajana yajas yaji yajus yajata izwi yajati yazwavya yazwf yajatra yajaTa yajYa yajyu yajIyas yajizWa yajvan yajvin yajizRu yAga yAja yAjaka yAjin yAjya yAjyA yAjana yAjanIya yAjuka yAyajUka yiyakzu yAjayitavya yAjayitf
yat	yat	yat yAt yatana yatanIya yati yatti yattavya yatitavya yatna yAtaka yAtya yAtana yAtanA yatuna yayAti
yaB	yaB	yaBya yABa
yam	yam	yama yama yamaka yamin yamya yamana yati yaMtu yaMtavya yaMtur yaMtf yaMtra yamunA yamIyas yamizWa yamasAna yAma yAmaka yAmin yAmana yaMsenya yaCana yazwi
yas	yas	yAs yAsa yAsaka yAsin yAsya yAsana yaska
yA	yA	yA yAna yu yAti yAtu yAtavya yAtf yAtra yAtrA yATa yAma yAman yAyin yAvan yezWa yayi yayI yayin yiyu yayu yAyAvara yiyAsA yiyAsu yApa yApaka yApya yApana
yAc	yAc	yAcaka yAcin yAcya yAcana yAcanA yAcanIya yAcitavya yAcitf yAcizRu yAcYA yAcYya
yAd	yAd	yAdas yAdura
yu1	yu	yu yava yavana yuvana yut yuti yUti yotra yUTa yUna yoni yuvan yavizWa yavIyas yos yozaRA yAva yAvana yAvayitf
yu2	yu	yava yavana yut yuti yotf yutvan yAvan yAvana yUyuvi
yuj	yuj	yuj yuja yujya yuga yugya yuNga yuYjaka yoga yogya yogyA yogin yojaka yojya yojana yojanIya yukti yoktavya yoktf yoktra yojitf yugma yugman yugvan yuyukzu yojayitavya yojayitf
yuD	yuD	yuD yuDa yuDi yuDya yuDenya yuDma yuDvan yoDa yoDaka yoDin yoDya yoDana yoDanIya yoDuka yoDIyas yodDavya yodDf yuyuDi yUyuDi yavIyuD yuyutsA yutsA yuyutsu
yup	yup	yUpa yopana yoyupana
rakz	rakz	rakza rakzA rakzaka rakzin rakzya rakzaRa rakzaRA rakzaRIya rakzas rakzas rakzi rakzitavya rakzitf rirakzA rirakzu rirakzizA rirakzizu
raMh	raMh	raNha raNhya raNhas raNGas rahas raNhi fhant raGu laGu raGIyas laGIyas laGizWa
rac	rac	racana racanA raYca raYcya raYci racayitf
raj2	raYj	raNga raYjaka raYjya rajaka raYjana raYjanIya rajana rajani rajanI rajanIya rajas raji rajata rakti rAga rAgin rajayitf
raw	raw	rawana rawi
rad	rad	rada radana
raD	raD	ranDana randDi ranDra raDra
ran1	raR	ran raRa raRya raRya ranti rantya raRitf raRva raRvan
ran2	raR	raRana
rap	rap	rAp rApin
rapS	rapS	rapSa rapSin
raB	raB	raBa raBya raBas raBasAna razBi raBin rabDi rabDavya rabDf raBizWa raBIyas raByas ramBa ramBaka ramBin ramBana ramBanIya ripsu
ram	ram	rama ramya ramaRa ramaRIya rati raMti ramati ramati raMtavya raMtf rAtrI rAma rAmin rAmaRa raMsu riraMsA riraMsu riramayizu
ramb	ramb	rambaRa
ras	ras	rasana rasitf
rah	rah	raha rahin rahaRa rahas rahasya rahasyu rahU
rA1	rA	rA rE rA rAya rayi rayizWa ratna rAkA rAti rAvan rarAvan raru
rA2	rE	rAvan
rAj	rAj	rAj rAja rAjan rAjan rAjana rAjin rAzwrI rAzwra
rAD	rAD	rADa rADin rADya rADana rADanIya rADas rADi rAdDi rAdDf rADayitf rADayizRu
rAs1	rAs	rAsa rAsaBa
ri	rI	raya rit rIti retas reRu
riK	riK	reKA
riNK	riNK	riNKaRa riNgin riNgi
ric	ric	reka rekin reca recaka recya recana recanIya riYca riYcya riYci reku rikti rikTa rekRas rikvan
rip	rip	rip repas ripu ripra
riP	riP	rePa
riB	riB	reBa
riS	riS	riSA
riz	riz	riz rez riza reza rezin rizaRa rezaRa rizwi rizIka rezman ririkzu
rih	rih	rehaRa reriha
ru1	ru	rava ravaRa ruvaRa ravas ravitf favaTa ruvaTa ruma rAva rAvin rAvaRa rAvan
ru2	ru	ravitf rAvin
ruc	ruc	ruc ruca rucA rucaka rucya roca rocaka rocin roka roka rokin rocana rocas ruci ruci roci rocis rocuka rukma rukmant rucira rukza rucizya rocizRu ruSa ruSant
ruj	ruj	ruj ruja rujA roga loga rujana rogaRa rujAnA rujatnu rurukzaRi
rud	rud	rud ruda roda rodana rudana rodas roditavya rudra roruda rurudizu rurudizA
ruD1	ruD	ruD roDa roDana
ruD2	ruD	ruD ruDa roDa roDaka roDin roDya roDana roDanA roDas roDuka rudDi rodDavya rodDf rurutsu
rup	rup	ropaRa ropi ropuzI
ruz	ruz	ruz roza rozaRa rozin
ruh	ruh	ruh ruha roha rohaka rohin rohya rohaRa rohaRIya rohas rohuka rUQi roQavya roQf rurukzu ropa ropaka ropin ropya ropaRa ropaRIya ropayitf
rUz	rUz	rUzaRa rUkza
lakz	lakz	lakza lakzaka lakzya lakzaRa lakzaRIya lakzman lakzmI lakzayitavya
lag	lag	lagana laganIya liNga
laNG	laNG	laNGaka laNGin laNGya laNGana laNGanIya
lajj	lajj	lajjA
lap	lap	lap lapya lapana lapanIya lapti lapitavya lApa lApaka lApin lApya lApana
laB	laB	laBa laBya lABa lABaka lABin laBana laBanIya labDi labDavya labDf lamBa lamBaka lamBin lamBya lamBana lamBanIya lamBuka lipsA lipsu lipsitavya lIpsitavya
lam	lam	lamaka
lamb	lamb	lamba lambaka lambin lambya lambana lambuka lambitavya
lal	lal	lalana lAla lAlaka lAlya lAlana lAlanIya lAlayitavya lAlin
laz	laz	lazya lazaRIya lAza lAzaka lAzin lAzuka
las	las	las lasa lasana lAsana lAsa lAsaka lAsin lAsya lAlasa
liK	liK	liKya liKana leKa leKA leKaka leKin leKya leKana leKanIya liKitf
lip	lip	lepa lepaka lepin lepya lepana lipi limpa limpi lipti
liS	liS	leSa lezwu
lih	lih	lih liha leha lehaka lehin lehya lehana leliha
lI1	lI	laya layana layu lIyana lAya lAyaka lAyya lAyana leya lApya lApana lApayitavya
luYc	luYc	luk luYca luYcaka luYcana
luW1	luW	loWana
luW2	luW	luRWA luRWaka luRWana luRWi
luq	luq	loqana loqayitf
lup	lup	lup lupya lopa lopaka lopin lopya lopana lupti loptf loptra lumpaka lumpana lolupa
luB	luB	loBa loBaka loBin loBya loBana loBanIya
lul	lul	lola lolana
lU	lU	lava lavya lavana lAva lAvaka lavitavya
lok	lok	loka lokaka lokin lokya lokana lokanIya lokayitf lokayitavya
loc	loc	loca locaka locya locana locanIya
vakz	vakz	vakzaRa vakzaRA vakzaRi vakzaTa vakzas
vac	vac	vAc vaca ucya vAka vAkin vAkya vAcaka vAcin vAcya vacana vacana vacanIya vAcana vAcanIya vacas vAcas vAku ukti vakti vaktva vaktavya vaktf vaktra ukTa ucaTa vagnu vakman vakmya vagvana vagvanu vivakzA vivakzu vAcayitf vAcayitavya
vaj	vaj	vAja vAjana ojas oja ojizWa ojIyas ojman ugra vajra
vaYc	vak	vaYcaka vaYcana vaYcanIya vaNku vaNkri vakra vakva vakvan vaYcayitf vaYcayitavya
vad	vad	vad vadya udya vAda vAdaka vAdin vAdya vadana vAdana vAdanIya vaditavya vAditavya vaditf vAditra vadizu vadizRu vadizWa vAduka vadman vadAvada vadAvadin vAdayitf vivAdizu
vaD	vaD	vaDa baDa vaDaka vaDya baDya vaDanA vaDatra vaDar vaDyA vaDra vaDri vaDasna vaDasnu
van	van	van vana vanin vanya vanad vanana vananA vananIya vanas vani vanu vanus vantf vanitf vanizWa vanIyas vAnya vAma vanIvan vAvAta vAvAtf vanayitf
vand	vand	vanda vandya vandin vandana vandanIya vandAru vanditavya vanditf vivandizu
vap1	vap	vapa vapA upya vApa vApaka vApin vApya vapana vapanIya vApana vApI upti vaptavya vaptf vapra vapizWa vApayitf
vap2	vap	vapana vApa vApana vaptf
vam	vam	vami vAmin vamana vAmanIya vamitavya vamaTu vamra
val	val	valana vali valaya
valg	valg	valgA valgin valgana valgu
valh	valh	valha valhaka
vaS	vaS	vaSa uSa uSanA uSanas uSenya vaSi uSI uSij vazwi vaSitf vaSIyas
vas1	vas	uz uzA Uza uzar usf uzas uzwi vastu vastf vasu vasizWa vasIyas vasyas usra usri vAsa vAsana vAsara vivasvan vivasvant
vas2	vas	vas vasa vasya vAsa vAsin vasana vAsana vAsas vasanta vasitavya vasitf vastf vastra vasman
vas3	vas	vas vasa uzaka uzya vAsa vAsaka vAsin vAsya vasana uzaRa vAsana vAsanIya vAsas vasu vasati vastu vastavya uzitavya vAstu vastf vasaTa vasman vAsayitavya vAsayitf
vah	vah	vah vAh vaha vahin vahya oGa OGa vAha vAhaka vAhin vAhya vahana vAhana vAhanIya vahat vAGat vAhas UQi vahatu voQavya vAhitavya voQf vAhitf vahitf vahitra vahizWa vAhizWa vahIyas vahni vahman vakzas vakzaRa vakzI vAvahi vIvaDa vAhayitf
vA1	vA	vA vAna vAta vAyu vAyya vApaka vApana vApayitf vApayitavya
vA2	ve	vAya vAyaka vayana vAna vayuna Uti otu vAtavya vayitf veRI vema veman
vAYC	vAYC	vAYCA
vAS	vAS	vaSA vASa vASaka vASin vASya vASana vASra
vic1	vic	veka vekin vekya vecaka vecana vikti vektavya vektf vivici
vij	vij	vij vega vejaka vejin vejana vigra vevija vijitavya
vid1	vid	vid vida veda vedaka vedin vedya vedyA vedana vedanIya vedi
vid2	vid	vid vidya veda vedaka vedin vedya vedana vedanIya vedas veduka vitti vettavya vettf vedizWa vedIyas vidAyya vinda vindu vindaka vivitsu
vinD	vinD	viDu viDava viDura
vip	vip	vip vipana vipas vepa vepin vepana vepas vepaTu vepizWa vipra
viS	viS	viS viSa veSa veSI veSaka veSin veSya viSana veSana veSanIya veSanta veSas vizwi vezwavya vezwf veSman vivikzu veSayitavya
viz	viz	viz viza viza veza vezaka vezin vezya vezaRa vezaRa vizaya vizwi vezwavya vezwf vizRu vivikzu
vizw	vezw	vezwa vezwaka vezwana vezwanIya vezwitf
vIj	vIj	vIjana vyajana
vIq	vIq	vIqu
vf1	vf	vAr vara varaka vala urA vra varaRa varaRa varaRIya uraRa varas uras uru ft vfti vartu vartf varItf varUtf vartra varatrA varUTa varRa varuRa UrRA varman variman varIman Urmi varIyas varivas varizWa ulba Urva vAra vAraka vArin vArya vAraRa vAraRIya UrRavana vavra vavri vArayizRu vivArayizu vArayitavya
vf2	vf	vara vara varaka varya varya vUrya varaRa varaRIya vareRya varas vfTA vfTak vAra vArya vAraRa varizWa varIyas varayitavya
vfj	vfj	vfj Urj varga vargya varja varjaka varjin varjya vraja vrAja vfjya vfjana vfjana vfjanI varjana varjanIya vfYjana vfjina vfkti varjayitavya varjayitf
vft	vft	vft vftA varta vartaka vartin vartya vrata vrata vartana vartanIya vartani vartas varti vartis vftti varttu varttavya vartitavya vartitf vratati vartman varIvfta vivftsu vartayitavya vartayitf
vfD	vfD	vfD vfDa varDa varDaka varDin varDana varDanIya vfDas vfDIka vfdDi varDitf varDman vardDra UrDva vfDasAna varDizRu vAvfDenya varDayitf vivarDayizu varDApana
vfz	vfz	vfz vfza varza varzin varzya varzaRa varzuka vfzwi varzwf varzitf vivarzizu vfzan vfzRi vfzaBa
vfh	bfh	vfha barha varha barhin varhin barhaRa varhaRa barhis
ven	ven	vena venya
vell	vell	vellana
vyac	vyac	vyacas vyacizWa vIci
vyaT	vyaT	vyaTA vyaTaka vyaTya vyaTana vyaTi vyaTi vyaTis vyATa viTura vyaTayitf vyaTin
vyaD	vyaD	viD viDya veDa veDaka veDin veDya vyaDa vyaDya vyADa vyADin vyADya veDana vyaDana vedDavya vedDf veDima vyaDvara
vyA	vye	vI vyAya vyAna vyayana
vraj	vraj	vrAj vrajya vrajyA vrAja vrAjaka vrAjin vrajana vrAjana vivrajizu
vrad	vrad	vrandin
vran	vraR	vraRa
vraSc	vraSc	vfka vfScika vraSca vraska vraskya vraScana vfkza
vrIq	vrIq	vrIqa vrIqA vrIqana
vlI	vlI	vlaya vlayana vrayas
Sak	Sak	Saka Sakya SAka SAka SAkI SacI SAci Sakti Sakti Sakman SAkman Sikman Sagma Sakra Sikva Sakvan Sikvan Sikvas SacizWa SikzA SIkzA Sikzaka Sikzin SikzaRa SikzaRIya SikzeRya Sikzu Sikzuka
SaNk	SaNk	SaNkA SaNkin SaNkya SaNkana SaNkanIya SaNkitavya
SaMs	SaMs	Sas SAs Sasa SasA Sasya SaNsa SaNsA SaNsaka SaNsin SaNsya SaNsana SaNsanIya SaNsu SaNsuka Sasti Sastenya SaNstavya Saatavya SaNsitf SaNstf Sastra SaNsaTa Sasman
Sad1	Sad	Satru
Sad2	Sad	Sada SAda SAdana
Sap	Sap	SApa Sapana Sapana Saptf SapaTa
Sam1	Sam	Sama Sami SamI Sima SimI Samitf SamizWa
Sam2	Sam	Sam Sama Samin SAmaka SAmya Samana SamanIya SaMti SAMti Samitf SamaTa Samayitavya Samayitf
Sam3	Sam	SAmana Samaya SAmayitavya
SaS	SaS	SaSa
Sas	Sas	Sas SAsa Sasana Sasitf Sastf Sastra SAstf SiSAsizu
SA	Si	SAna SARa Siti SiSaya
SAs1	SAs	SAs Siz SAsa SAsA SAsa SAsaka SAsin SAsya Sizya SAsana SAsanIya SAsus SAsti Sizwi SAsitf SAstf SAstra
SiYj	SiYj	SiYjin SiYjAra
Siz	Siz	Siza Seza Sezaka Sezin Sezya SezaRa Sezas
SI1	SI	SAyana
SI2	SI	SI Sa Saya SayA Sayin SayyA SAyaka SAyin Sayana SayanIya SAyana Sayu Sayitavya SayaTa SITa SIma Seyya SayAlu SIvan SiSayizu
Suc	Suc	Suc Suca Suka Soca Socin Socya Soka Soka Socana SocanIya Sokas Suci Soci Sucis Socis Sukti Socitavya Sukra Sukla Sukvan SocizWa SuSukvana SuSukvani SuSukzaRi SocayizRu
SuD	SuD	SoDa SoDaka SoDin SoDya SunDana SoDana SoDanIya SudDi SunDyu SoDayitavya
SuB	SuB	SuB SuBa SoBa SoBA SoBin SumBa SumBaka SoBana SoBana Sumbana SumBU SoBaTa SuBra SuBri SuBvan SoBizWa SoBayitf
Suz1	Suz	Suza Soza Sozaka Sozin Sozya SozaRa SozaRIya Sozuka Suzka SuzRa Sozayitf
SU	Svi	SU Sava SAva Svan Savas SavasAna SavizWa SoTa Suna SUna SUnya SUra SavIra Siva Seva Sevas SvAyin Svayana SvayaTa SvayaTu SvAtra SvAnta SiSu SiSvan SiSvi
Sf1	SF	Sir Sar Sara Sara Sala Salya SIrya SUla SaraRa SaraRi SUraRa SarIka SarIra SarAru SAri Saru Sarva SAruka SIrti Saluna SaraBa Salala SalalI SalAka SiSarizu
SfD	SfD	SarDa SarDin SarDya SfDyA SarDana SarDas SarDayitf
Scand	cand	candana Scandra candra
Scut	Scut	Scut Scotana
SnaT	SnaT	SnaTana SnaTitf SiSnaTa
SyA	SyE	SyA SyAya SiSira
SraT	SraT	SraTa SraTar SlaTa
Sran	SraR	SrARana SrARika
Sram	Sram	Srama SrAma SramaRa SramaRa SrAMti SramizWa SiSramizu
SramB	SramB	SfmBa SramBa Srambin SramBana SramBanIya SrabDi
SrA	SrA	SIra Saras Srapa SrApin SrapaRa Srapayitf
Sri	Sri	SrI Sraya Srayin SrAya SAra SAlA SrayaRa SrayaRIya SaraRa Srit Sriti Srayitavya Sretf SreRi Sarman Sarira
SrI1	SrI	Sir Sira SrI SrayaRa
Sru	Sru	SrU Srava Sravya SravAyya SrAva SrAvaka SrAvin SrAvya SravaRa SravaRIya SrAvaRa SrAvaRIya Sravas Sloka Srut Sruti Srutya Srotu Srotavya Srotf Srotra SrAvitf SruDi SruRa Sromata SravizWa SrOzaw SuSruka SuSrUs SuSrUzA SuSrUzaka SuSrUzin SuSrUzya SuSrUzaRa SuSrUzeRya SuSrUzu SuSrUzitf SuSrUzitavya SrAvayitf SrAvayitavya
SlAG	SlAG	SlAGA SlAGin SlAGya SlAGana SlAGanIya SlAGizWa
Sliz	Sliz	Sriz Sliz Sreza SreziRa Sleza Slezaka Slezin SlezaRa Srezman Slezman SiSlikzu
SvaYc	Svac	SvaNka
Svas	Svas	Svasa SvAsa SvAsin SvAsya Suza Soza Svasana SvasanIya SvAsana SvAsanIya Svasi Svasitavya SvasaTa Suzma Suzman
Svit	Svit	Svit Sveta SvetanA Sviti Svitna Svitra
saG	saG	saGan
sac	sac	sac sAc saca sacA sAcin sAcya sacana sacas saci sAci saKi sacaTa sakman sakmya sakra sakzaRi saScat sAcaya
saj	saYj	saj saja sajya saYja saNga saNgin saNgya saYjana saYjanIya sajjana sakti saktu saktavya saNktavya
sad	sad	sad sada sadya sadya sadyA sAda sAdaka sAdin sAdya sadana sAdana sAdanIya sadas sadi sAdi sedi sandI seduka satti sattf sattra sanni sadman sadman sadvan sadvara satsnu sAdayitavya sisAdayizu
san	san	san sana sina sanana sA sa sani sani sAnuka saniti sanitva seya sAti sanitf sanitra sanutf sanitvan satvan sAtu sAman saneru sanIyas sanizWa sAnasi sasni sizRu sizAsatu sizAsani sizAsu
sap	sap	sAp sapa sapin sapar sapti
sas	sas	sasa
sah	sah	sah sAh saha saha sahaka sahya sahya sAha sAha sAhin sAhya saBa siNha sahan sahana sahinIya sAhana sahantya sahas sahasAna sAhi sehu sAQi soQavya sahitavya sAQf soQf sahuri sahIyas sahyas sahizWa sahyu sahizRu sahvan sakza sakzin sakzaRa sakzaRi sAsahi
sA1	si	sA sAya sAyin seya sAna sAtf sya siti setu setavya setf sinva
sAD	sAD	sAD sADa sADaka sADin sADya sADana sADanIya sADas sADu sADu sadDi sADIyas sADizWa sADayitavya sADayitf sizADayizA sizADayizu
sic	sic	sic sicya sicya seka sekin sekya secaka secya secana secanIya sikti sektavya sektf secitf sikTa
siD1	siD	seDa seDaka seDin seDya seDana seDanIya sidDi sedDavya sedDf sedDra siDma siDman seDayitf
siD2	siD	siD sidDi siDma siDra siDvan
sIv	siv	syU sIvaka sIvya seva sevana sIvana sevitavya sUtra sUna syuman syona
suB	suB	soBari soBarI
sU	su	sU sava savya savin savana suvana savas sUti suti sUtu savitf savItf sUtrI strI savaTa sUna sUnu sUma sUya sUra sUri savIman sUvan sUzA sUzaRA
sUd	sUd	sUd sUda sUdaka sUdin sUdana sUdayitnu
sUrkz	sUrkz	sUrkzya
sf	sf	sara saraka sarin sAra sAraka sArin sArya sirA sIrA saraRa saraRi sAraRa sAraRIya saras sarit saru sft sfti sftya sftyA sartu sartavya sartf sftvan sftvara sarma sarman sarIman saramA sfmara sarayu sarira salila sarala sasra sasri sisArayizu
sfj	sfj	sfj sraj sfjya sarga sargin sarja sarjya sarjana sfzwi sfzwi srazwavya srazwf sfjaya sfjayA sisfkzA sisfkzu sarjayitavaya
sfp	sfp	sfp sfpya sarpa sarpaka sarpin sarpaRa sarpi sarpis sfpti sfpra sasarparI sarIsfpa
sev	sev	sevA sevaka sevin sevya sevana sevanIya sevitavya sevitf sizevayizu
skand	skand	skanda skandin skandya skandana skadvarI skanDa skanDas
skamB	skamB	skaBa skamBa skamBaka skamBin skamBana skaBIyas
sku	sku	skava skavana
sKal	sKal	sKala sKalana
stan	stan	stana stAnaka stanana stAmu stanaTa stanaTu izwani stanayitnu
stamB	stamB	stamBa stamBaka stamBin staBa staBya staBu stamBana stamBanIya stabDi stamBayitf stamBayizu
stu1	stu	stu stava stavya stAva stAvaka stAvya stavana stavanIya stAvanA stut stuti stutya stotavya stotf stotra stavaTa stoma stavAn stuzeyya
stuB	stuB	stuB stuBa stoBa stoBana stobDavya stuBvan
stf	stf	stf stir stuf stara starya starya stAra stAraka stArin staraRa stfti stftya starItu staritf starIman stfRa
styA	styE	stiyA styAya styAyana stIma stImin
sTag	sTag	sTagaka sTagana
sTA	sTA	sTA sTa sTin sTAya sTAyaka sTAyin sTAna sTi sTeya sTeya sTu sTf sTAyuka sTiti sTiti sTAtavya sTAtur sTAtf sTAtra sTARu sTAman sTeman sTeyas sTira sTAla sTAlI sTAvan sTAvara sTAsnu tasTu tizWAsA tizWAsu sTApaka sTApin sTApya sTApana sTApanIya TApitf sTApayitavya sTApayitf
snA	snA	snA sna snAyin sneya snAna snAtf snAtva snAtavya sizRAsu snApaka snApana snapana
snih	snih	snih sneha snehaka snehin snehya snIhan snehana snIhiti snehiti snehayitavya
snu	snu	snu snava snAvin
spand	spand	spanda spandin spandana panizpada
spf	spf	spara sparaRa spft spfti spartf
spfD	sparD	spfD sparDA sparDin sparDya sparDanIya sparDas
spfS	spfS	spfS spfSa spfSya sparSa sparSin sparSana sparSanIya spfSi spfzwi sprazwavya sprazwf sparSitf pispfkzu sparSayitavya
spfh	spfh	spfh spfhA spArha spfhaRa spfhaRIya spfhayAlu spfhayAyya
sPaw	sPaw	sPawika
sPal	sPal	sPAlana
sPA	sPAy	sPAka sPAna sPati sPIti sPira sPAvayitf
sPuw	sPuw	sPuwa sPowa sPuwana sPowana
sPUrj	sPUrj	sPUrja sPUrjaka sPURjana sPUrjaTu sPUrji
sPf	sPur	sPur sPura sPAra sPuraRa sPUrti sPuliNga
smi	smi	smaya smayAka smAya smayana smayanIya smetavya smera smApaka smApana smApanIya smApayanIya sismApayizu
smf	smf	smara smarya smAra smAraka smArin smAraRa smaraRa smaraRIya smft smfti smartavya smartf
syand	syand	syad syada syanda syandaka syandin syandyA syandana syedu syanttf syandra sasyad sanizyada
sraMs	sraMs	sras srasA srasya sraNsa sraNsaka sraNsin sraNsana sanisrasa
sriD	sriD	sriD
srIv	sriv	srIvi sreman
sru	sru	srU sruva srava sravin srAva srAvin srAvya sravaRa srAvaRa sravas sravat sruc srut srutya sruti srotas srotyA sravaTa srAvayitavya
svaj	svaj	svaja svajya svaNga svaNgin svajana svajIyas svaYjalya
svad	svad	svada svAda svAdaka svAdin svAdya svAdana svAdanIya svAdas svAdu svAdIyas svAdizWa svAdman svAdman svAdiman svadayitf
svan	svan	svan svana svAna svAnin svanas svani svanaya
svap	svap	sup svApa svApin svapana svApana supti svaptavya svapitf svapna suzupsA suzupsu
svar	svf	svar svara svara svarya svAra svArya svaraRa svaras svari svaru svaritf svartf svarIyas svarayitavya
svid	svid	sveda svedin svedya svedana svedu
had	had	hAda hadana
han	han	han ha hana Ga Gana Gna Gnya Gni GnI hanana hanas hanu hat hati hatya hatyA hanti hantu hantva hantavya hantf haTa hatnu hanman hanIyas hanizWa jaGana GanAGana jaGni jaNGA jiGatnu jiGANsA jiGANsu hAta GAta GAtaka GAtin GAtya GAtana GAtuka
has	has	has hasa hasa hasya hAsa hAsaka hAsin hAsya hasanA Hasana hasanIya hAsana hasra hasvan
hA1	hA	hA ha hAyaka hAyin hAyya hAna hAyas hAtavya hAni hi heya hAvarI hApana hApanIya jihAsA jihAsu jahaka jahAka jahana
hi	hi	haya heya hit hiti heti hetu hetva hetavya hetf heman heman hitvan hinva hezas hAyya
hikk	hikk	hikkA hikkin
hiMs	hiMs	hiNsA hiNsaka hiNsya hiNsana hiNsanIya hiNsitavya hiNsra
hiRq	hiRq	hiRqaka hiRquka
hIq	hIq	hIqa heqa helA heqana helana helanIya heqas helitavya
hu	hu	hava havya hAva havana havis hut huti hotavya hotf hotra hotrA homa homan hoza juhU juhUzu
hU	hve	hU hUya hava havin havya havyA hAva huvana havana havas hUti havItu hUtavya hotf hotrA homan havIman hiavizWa hvA hva hvaya hvAyaka hvayana hvAna hvAtavya hvayitavya hvAtf jihvA johUtra hvAyayitavya
hf1	hf	hara hAra hAraka hArin hArya haraRa haraRIya hAraRa haras hAruka hft hfti hftya hartavya hartf jihIrzA jihIrzu hArayitavya
hf2	hf	hfRAy hfRIy
hfz	hfz	harza harzaka harzin harzaRa hfzI harzi harzu hfzwi Gfzu Gfzvi
hez	hez	heza hezA hezas
hnu	hnu	hnava hnavana hnuvana hnuti hnotf hnavAyya
hras	hras	hrAsa hrAsana hrAsanIya hrasizWa hrasIyas hrasva
hrAd	hrAd	hrAda hrAdin hrAdana hrAdi
hrI	hrI	hrI hri hraya hrIti hrepaRa
hrez	hrez	hrezin hrezuka
hlAd	hlAd	hrada hlAda hlAdaka hlAdin hlAdana hlAduka hlAduni hrAduni hlAdayitf
hval	hval	hvala hvalA hvalin hvAla
hvf	hru	hUrya hvara hvaraka hvAra huras hvaras hvft hrut hvfti hruti
